{
  "name": "winter_wonderland_0001",
  "tileset": "icy",
  "width": 20,
  "height": 15,
  "layers": [
    [
      {
        "tiles": [
            1,  1,  1,  1,  1,  1,  6,  1,  1,  1,  1,  1,  1,  1,  1,  1,  1,  1,  1,  6,
            1,  1,  1,  1,  1,  1,  6,  1,  1,  1,  1,  1,  1,  1,  1,  1,  1,  1,  1,  6,
            1,  1,  1,  1,  1,  6,  1,  1,  1,  1,  1,  1,  1,  1,  1,  1,  1,  1,  1,  6,
            1,  1,  1,  1,  1,  1,  6,  1,  1,  1,  1,  1,  1,  1,  1,  1,  1,  1,  1,  6,
            1,  1,  1,  1,  1,  6,  1,  1,  1,  1,  1,  1,  1,  1,  1,  1,  1,  1,  1,  6,
            1,  1,  1,  1,  1,  6,  1,  1,  1,  1,  1,  1,  1,  1,  1,  1,  1,  1,  6,  1,
            1,  1,  1,  1,  1,  6,  1,  1,  1,  1,  1,  1,  1,  1,  1,  1,  1,  1,  6,  1,
            1,  1,  1,  1,  1,  1,  1,  1,  1,  1,  1,  1,  1,  1,  1,  1,  1,  1,  6,  1,
            1,  1,  1,  1,  1,  1,  1,  1,  1,  1,  1,  1,  1,  1,  1,  1,  1,  1,  6,  1,
            1,  1,  1,  1,  1,  1,  1,  1,  1,  1,  1,  1,  1,  1,  1,  1,  1,  1,  6,  1,
            1,  1,  1,  1,  1,  1,  1,  1,  1,  1,  1,  1,  1,  1,  1,  1,112,113,114,  6,
            1,  1,  1,  1,  1,  1,  1,  1,  1,  1,  1,  1,  1,  1,  1,  1,120,121,122,  6,
            1,  1,  1,  1,  1,  1,  1,  1,  1,  1,  1,  1,  1,  1,  1,  1,128,129,130,  6,
            1,  1,  1, 89,  1,  1,  1,  1,  1,  1,  1,  1,  1,  1,  1,  1,  1,  1,  1,  6,
            1,  1,  1,  1,  1,  1,  1,  1,  1,  1,  1,  1,  1,  1,  1,  1,  1,  1,  1,  6
        ],
        "width": 20,
        "x": 0, "y": 0
      }
    ],
    [
      {
        "tiles": [
           -1, -1, -1, -1, -1, -1, -1, -1, -1, -1, -1, -1, -1, -1, -1, -1, -1, -1, -1, -1,
           -1, -1, -1, -1, -1, -1, -1, -1, -1, -1, -1, -1, -1, -1, -1, -1, -1, -1, -1, -1,
           -1, -1, -1, -1, -1, -1, -1, -1,  2, -1, -1, -1, -1, -1, -1, -1, -1, -1, -1, -1,
           -1, -1, -1, -1, -1, -1, -1, -1, -1, -1, -1, -1, -1, -1, -1, -1, -1, -1, -1, -1,
           -1, -1, -1, -1, -1, -1, -1, -1, -1, -1, -1, -1, -1, -1, -1, -1, -1, -1, -1, -1,
           -1, 10,  3, -1, -1, -1, -1, -1, -1, -1, -1, -1, -1, -1, -1, -1, -1, -1, -1, -1,
           -1, -1, -1, -1, -1,  3, -1,  2, -1, -1, -1, -1, -1, -1, -1, -1, -1, -1, -1, -1,
           -1, -1, 11, -1, -1, -1, -1, -1, -1, -1, -1, -1, -1, -1, -1, -1, -1,  2, -1, -1,
           -1, -1, -1, -1, -1, -1, -1, -1, -1, -1, -1, -1, -1, -1, -1, -1, -1, -1, -1, -1,
           -1, -1, -1, -1, -1, -1, -1, -1, -1, -1, -1, -1, -1, -1, -1, -1,104,105,106, -1,
           -1, -1, -1, -1, -1, -1, -1, -1, -1,  4, -1, -1, -1, -1, -1, -1, -1, -1, -1, -1,
           -1, -1, 99,100,101, -1, -1, -1, -1, -1, -1, -1, -1, -1, -1, -1, -1, -1, -1, -1,
           -1, -1,107,108,109, -1, -1, -1, -1, -1, -1, -1, -1, -1, -1, -1, -1, -1, -1, -1,
           -1, -1, 88, -1, 90, -1, -1, -1, -1, -1, -1, -1, -1, -1, -1, -1,136,137,138, -1,
           -1, -1, 96, 97, 98, -1, -1, -1, -1, -1, -1, -1, -1, -1, -1, -1, -1, -1, -1, -1
        ],
        "width": 20,
        "x": 0, "y": 0
      }
    ],
    [
      {
        "tiles": [
           36, 37, 38,
           44, 45, 46,
           52, 53, 54
        ],
        "width": 3,
        "x": 2, "y": 2
      },
      {
        "tiles": [
           36, 37, 38,
           44, 45, 46,
           52, 53, 54
        ],
        "width": 3,
        "x": 5, "y": 3
      },
      {
        "tiles": [
           13, 14,
           21, 22
        ],
        "width": 2,
        "x": 5, "y": 7
      },
      {
        "tiles": [
           91, 92, 93
        ],
        "width": 3,
        "x": 2, "y": 10
      }
    ]
  ]
}
